empilement 2,20,9;
++.++.++.++.++.++.++
++.++.++.++.++.++.++
++.++.++.++.++.++.++
++.++.++.++.++.++.++
++.++.++.++.++.++.++
++.++.++.++.++.++.++
++.++.++.++.++.++.++
++.++.++.++.++.++.++
++.++.++.++.++.++.++;
....................
.#........#........#
....#...........#...
.......#..#..#......
.......&.....&......
....................
.......#..#..#......
....#...........#...
.#........#........#;