empilement 5,11,9;
+..++.++..+
..+++.+++..
.++++.++++.
+++++.+++++
...........
+++++.+++++
.++++.++++.
..+++.+++..
+..++.++..+;
+...+.+...+
...++.++...
..+++.+++..
.++++.++++.
...........
.++++.++++.
..+++.+++..
...++.++...
+...+.+...+;
...........
....+.+....
...++.++...
..+++.+++..
...........
..+++.+++..
...++.++...
....+.+....
...........;
...........
...........
....+.+....
...++.++...
...........
...++.++...
....+.+....
...........
...........;
...........
...........
...........
....+.+....
...........
....+.+....
...........
...........
...........;