empilement 8,15,5;
+++++++++++++++
.....+++++.....
.....+++++.....
.....+++++.....
+++++++++++++++;
+....++++++++++
.....+++++.....
.....+++++.....
.....+++++.....
++++++++++....+;
.....++++++++++
.....+++++.....
.....+++++.....
.....+++++.....
++++++++++.....;
.....++++++++++
.....+...+.....
.....+.+.+.....
.....+...+.....
++++++++++.....;