Le nuage,14,7;
++++++++++++++
++++++++++++++
++++++++++++++
++++++++++++++
++++++++++++++
..............
...#########..;
+.+.+.+.+.+.+.
+.+.+.+.+.+.+.
+.+.+.+.+.+.+.
+.+.+.+.+.+.+.
..............
..............
...%%%%%%%%...;
+.+.+.+.+.+.+.
+.+.+.+.+.+.+.
+.+.+.+.+.+.+.
+.+.+.+.+.+.+.
..............
..............
......%.......;
