empilement 11,12,6;
....++++....
++++++++++++
..+++..+++..
..+++..+++..
++++++++++++
....++++....;
....++++....
.++++++++++.
..+++..+++..
..+++..+++..
.++++++++++.
....++++....;
....++++....
..++++++++..
...++..++...
...++..++...
..++++++++..
....++++....;
....++++....
...++++++...
....+..+....
....+..+....
...++++++...
....++++....;
............
....+..+....
............
............
....+..+....
............;