empilement 12,17,10;
+++++++++++++++++
+++++++++++++++++
+...............+
.................
+++++++++++++++++
+++++++++++++++++
.................
+...............+
+++++++++++++++++
+++++++++++++++++;
.................
.%%%%%%%%%%%%%%%.
.................
.................
.................
.#.#.#.#.#.#.#.#.
.................
.................
.................
.%%%%%%%%%%%%%%%.;