empilement 14,14,8;
++++......++++
++++.++++.++++
++++++++++++++
++++++++++++++
++++++++++++++
++++++++++++++
++++.++++.++++
++++......++++;
++++......++++
+..+.++++.+..+
+..++....++..+
+............+
+............+
+..++....++..+
+..+.++++.+..+
++++......++++;